1,Mugwaneza Prince,30,29,23,82,27.333333333333332
2,Richard MBANZA,40,30,50,120,40.0
1,Prince Honere,12,34,45,91,30.333333333333332
2,Prince Honere,34,50,70,154,51.333333333333336
3,Wesely,35,35,35,105,35.0
4,Jambo JD,23,20,20,63,21.0
,Mbanza Richard,34,21,20,75,25.0
,Mbanza Richard,34,21,20,75,25.0
,Serge Ndinda,23,12,50,85,28.333333333333332
,Joel Kahindo,45,56,32,133,44.333333333333336
,Ganza  Kelvin,45,34,23,102,34.0
,Gentil Herve,23,23,23,69,23.0
